{
  "name": "Тестова карта 1",
  "size": 50,
  "blocks": [ "grass", 
    "tree", "grass00", "grass01",
    "water00", "water01", "water02",
    "water03", "water04", "water05",
    
    "water06", "water07", "water08",
    "water09", "water10", "water11",
    "water12", "water13", "road00",
    
    "road01", "road02", "road03",
    "road04", "road05", "road06",
    "road07", "road08", "road09",
    
    "road10", "road11", "road12",
    "grass01", "wall", "earth", "hut"
  ],
  "map": [
    4, 4, 4, 4, 4, 4, 4, 4, 4, 4, 4, 4, 4, 4, 4, 4, 4, 4, 4, 4, 4, 4, 4, 4, 4, 4, 4, 4, 4, 4, 4, 4, 4, 4, 4, 4, 4, 4, 4, 4, 4, 4, 4, 4, 4, 4, 4, 4, 4, 4,
    4, 4, 4, 4, 4, 4, 4, 4, 4, 4, 4, 4, 4, 4, 5, 4, 4, 4, 4, 4, 4, 4, 4, 4, 4, 4, 4, 4, 4, 4, 4, 4, 4, 4, 4, 4, 4, 4, 4, 4, 4, 4, 4, 4, 4, 4, 4, 4, 4, 4,
    4, 4, 4, 4, 4, 4, 4, 5, 4, 4, 4, 4, 4, 4, 4, 4, 4, 4, 4, 4, 4, 4, 4, 4, 4, 5, 4, 4, 4, 4, 4, 4, 4, 5, 4, 4, 4, 4, 4, 4, 4, 4, 4, 4, 4, 4, 4, 4, 4, 4,
    4, 4, 4, 4, 5, 4, 4, 4, 4, 4, 4, 5, 4, 4, 4, 4, 4, 4, 5, 4, 4, 4, 4, 4, 4, 4, 4, 5, 4, 4, 4, 4, 4, 4, 4, 4, 4, 4, 4, 4, 4, 5, 4, 4, 4, 4, 4, 4, 4, 4,
    4, 4, 4, 4, 4, 4, 4, 4, 4, 5, 4, 4, 4, 4, 4, 5, 4, 4, 4, 4, 4, 4, 4, 5, 4, 4, 4, 4, 4, 4, 4, 5, 4, 4, 5, 4, 4, 4, 5, 4, 4, 4, 4, 4, 4, 4, 4, 4, 4, 4,
    4, 4, 4, 4, 4, 4, 4, 4, 4, 4, 4, 4, 4, 4, 4, 4, 4, 4, 4, 4, 4, 5, 4, 4, 4, 4, 4, 4, 4, 5, 4, 4, 4, 4, 4, 4, 5, 4, 4, 4, 4, 4, 4, 5, 4, 4, 4, 4, 4, 4,
    4, 4, 4, 4, 4, 5, 14, 12, 12, 12, 12, 12, 12, 12, 15, 4, 4, 4, 14, 12, 12, 12, 12, 12, 12, 12, 12, 15, 4, 4, 4, 14, 12, 12, 12, 12, 12, 12, 12, 12, 12, 12, 15, 4, 4, 4, 4, 4, 4, 4,
    4, 4, 4, 4, 4, 4, 10, 1, 32, 32, 32, 32, 32, 1, 11, 12, 12, 12, 13, 1, 2, 2, 2, 2, 2, 2, 2, 11, 12, 12, 12, 13, 1, 31, 27, 25, 25, 25, 25, 25, 25, 28, 9, 4, 4, 5, 4, 4, 4, 4,
    4, 4, 5, 4, 4, 4, 10, 1, 32, 33, 33, 33, 32, 1, 1, 1, 1, 1, 1, 1, 2, 6, 7, 7, 7, 8, 2, 1, 1, 1, 1, 1, 1, 1, 23,  18,  18,  18,  18,  18,  18, 22, 9, 4, 4, 4, 4, 4, 4, 4,
    4, 4, 4, 4, 4, 4, 10, 1, 32, 33, 33, 33, 32, 1, 1, 1, 1, 1, 1, 1, 2, 9, 4, 4, 4, 10, 2, 1, 1, 1, 1, 1, 1, 1, 23,  18,  18,  18,  18,  18,  18, 22, 9, 4, 4, 4, 4, 4, 4, 4,
    4, 4, 4, 5, 4, 4, 10, 1, 32, 33, 33, 33, 32, 1, 1, 1, 1, 1, 1, 1, 2, 9, 4, 4, 4, 10, 31, 1, 1, 1, 1, 1, 1, 1, 23,  18,  18,  18,  18,  18,  18, 22, 9, 4, 5, 4, 4, 4, 4, 4,
    4, 4, 4, 4, 5, 4, 10, 1, 32, 33, 33, 33, 32, 1, 1, 1, 1, 1, 1, 1, 2, 11, 12, 12, 12, 13, 2, 1, 1, 1, 1, 1, 1, 1, 23,  18,  18,  18,  18,  18,  18, 22, 9, 4, 4, 4, 4, 4, 4, 4,
    4, 4, 4, 4, 4, 4, 10, 1, 32, 32, 33, 32, 32, 1, 1, 1, 1, 1, 1, 1, 31, 2, 27, 25, 28, 2, 2, 1, 1, 1, 1, 1, 1, 1, 29,  20,  20, 21,  18,  19,  20, 30, 9, 5, 4, 4, 4, 4, 4, 4,
    4, 4, 4, 4, 4, 4, 10, 1, 1, 1, 2, 1, 1, 1, 1, 1, 1, 1, 1, 1, 1, 1, 23,  18, 22, 1,  1, 1, 1, 1, 1, 1, 1, 1, 1, 1, 1, 23,  18, 22, 6, 7,  17, 4, 4, 4, 4, 4, 4, 4,
    4, 4, 4, 4, 5, 4, 10, 1, 1, 1, 2, 1, 1, 1, 1, 1, 1, 1, 1, 1, 1, 1, 23,  18, 22, 1,  18,  18,  18,  18,  18,  18,  18,  18,  18, 1, 1, 23,  18, 22, 9, 4, 4, 4, 4, 5, 4, 4, 4, 4,
    4, 4, 4, 4, 4, 4, 16, 7, 8, 1, 2, 1, 1, 1, 1, 1, 1, 1, 1, 1, 1, 1, 23,  18, 22, 1,  18,  18,  18,  18,  18,  18,  18,  18,  18, 1, 1, 23,  18, 22, 9, 4, 4, 4, 4, 4, 4, 4, 4, 4,
    4, 4, 4, 4, 4, 4, 4, 4, 10, 1, 2, 1, 1, 1, 1, 1, 1, 1, 1, 1, 1, 1, 23,  18, 22, 1,  18,  18,  18,  18,  18,  18,  18,  18,  18, 1, 1, 23,  18, 22, 9, 4, 4, 4, 4, 4, 5, 4, 4, 4,
    4, 4, 5, 4, 4, 4, 4, 14, 13, 1, 2, 1, 1, 1, 1, 1, 1, 1, 1, 1, 1, 1, 23,  18, 22, 1,  18,  18,  18,  18,  18,  18,  18,  18,  18, 27, 25, 26,  18, 22, 9, 4, 4, 5, 4, 4, 4, 4, 4, 4,
    4, 4, 4, 4, 4, 4, 4, 10, 2, 2, 2, 1, 1, 1, 1, 1, 1, 1, 1, 1, 1, 1, 23,  18, 22, 1,  18,  18,  18,  18,  18,  18,  18,  18,  18, 23,  18,  18,  18, 22, 9, 4, 4, 4, 4, 4, 4, 4, 4, 4,
    4, 4, 4, 5, 4, 4, 4, 10, 2, 1, 1, 1, 1, 1, 1, 1, 1, 1, 1, 1, 1, 2, 23,  18, 22, 2,  18,  18,  18,  18,  18,  18,  18,  18,  18, 23,  18,  19,  20, 30, 9, 4, 5, 4, 4, 4, 4, 4, 4, 4,
    4, 4, 4, 4, 4, 4, 4, 10, 2, 1, 1, 1, 2, 27, 25, 25, 25, 25, 25, 25, 25, 25, 26,  18, 24, 25, 18, 18, 18, 18, 18, 18, 18, 18, 18, 26,  18, 22, 2, 1, 9, 4, 4, 4, 4, 4, 4, 4, 4, 4,
    4, 4, 4, 4, 4, 5, 4, 10, 2, 1, 1, 1, 31, 23,  18,  18,  18,  18,  18,  18,  18,  18,  18,  18,  18,  18,  18,  18,  18,  18,  18,  18,  18,  18,  18,  18,  18, 22, 2, 6,  17, 4, 4, 4, 4, 4, 4, 4, 4, 4,
    4, 4, 4, 4, 4, 4, 5, 10, 2, 2, 1, 1, 2, 29,  20,  20,  20,  20,  20,  20,  20,  20, 21,  18,  19,  20,  20,  20,  20,  20,  20,  20,  20,  20,  20, 21,  18, 22, 2, 9, 4, 5, 4, 4, 4, 4, 4, 4, 4, 4,
    4, 4, 4, 4, 4, 4, 4, 16, 8, 2, 1, 1, 2, 1, 1, 1, 1, 1, 1, 1, 1, 2, 23, 18, 22, 1, 1, 1, 1, 1, 1, 1, 1, 1, 1, 23,  18, 22, 2, 9, 4, 4, 4, 4, 5, 4, 4, 4, 4, 4,
    4, 4, 4, 4, 4, 4, 4, 4, 10, 2, 1, 1, 2, 1, 1, 1, 1, 1, 1, 1, 1, 1, 23,  18, 22, 1, 1, 1, 1, 1, 1, 1, 1, 1, 1, 23,  18, 22, 31, 9, 4, 4, 4, 4, 4, 4, 4, 4, 4, 4,
    4, 4, 4, 4, 4, 5, 4, 14, 13, 2, 1, 1, 2, 2, 2, 1, 1, 1, 1, 1, 1, 1, 23,  18, 22, 1, 1, 1, 1, 1, 1, 1, 1, 1, 1, 23,  18, 22, 2, 9, 4, 4, 4, 5, 4, 4, 4, 4, 4, 4,
    4, 4, 4, 4, 4, 4, 4, 10, 2, 2, 1, 1, 1, 1, 2, 1, 1, 1, 1, 1, 1, 1, 23,  18, 22, 1, 1, 1, 1, 1, 1, 1, 1, 1, 1, 23,  18, 22, 2, 9, 4, 4, 4, 4, 4, 4, 4, 4, 4, 4,
    4, 4, 4, 5, 4, 4, 4, 10, 2, 1, 1, 1, 1, 1, 2, 1, 1, 1, 1, 1, 1, 1, 23,  18, 22, 1, 1, 2, 1, 1, 1, 1, 1, 1, 1, 23,  18, 22, 2, 9, 4, 5, 4, 4, 4, 4, 4, 4, 4, 4,
    4, 4, 4, 4, 4, 4, 4, 10, 2, 1, 1, 1, 1, 1, 2, 1, 1, 1, 1, 1, 1, 1, 23,  18, 22, 1, 1, 1, 1, 1, 2, 1, 1, 1, 1, 23,  18, 22, 2, 9, 4, 4, 4, 4, 4, 4, 4, 4, 4, 4,
    4, 4, 4, 4, 4, 4, 5, 10, 2, 2, 2, 2, 2, 2, 2, 1, 1, 1, 1, 1, 1, 1, 23,  18, 22, 1, 1, 1, 1, 1, 2, 1, 1, 1, 1, 29,  20, 30, 2, 9, 4, 4, 4, 4, 5, 4, 4, 4, 4, 4,
    4, 4, 4, 4, 4, 4, 4, 10, 2, 2, 31, 2, 2, 2, 2, 1, 1, 1, 1, 1, 1, 1, 23,  18, 22, 1, 1, 1, 1, 1, 1, 1, 1, 1, 1, 1, 2, 1, 6,  17, 4, 4, 5, 4, 4, 4, 4, 4, 4, 4,
    4, 4, 4, 4, 4, 4, 4, 16, 8, 2, 2, 2, 2, 2, 2, 1, 1, 1, 1, 1, 1, 1, 23,  18, 22, 1, 1, 1, 1, 1, 1, 1, 1, 1, 1, 2, 2, 2, 9, 4, 4, 4, 4, 4, 4, 4, 4, 4, 4, 4,
    4, 4, 4, 4, 4, 5, 4, 4, 10, 2, 2, 2, 2, 31, 2, 1, 1, 1, 1, 1, 1, 1, 23,  18, 22, 1, 1, 1, 1, 1, 1, 1, 1, 1, 1, 2, 2, 2, 9, 4, 4, 4, 4, 4, 4, 4, 5, 4, 4, 4,
    4, 4, 4, 4, 4, 4, 4, 4, 10, 31, 2, 2, 2, 2, 2, 1, 1, 1, 1, 1, 1, 1, 23,  18, 22, 1, 1, 1, 1, 1, 1, 1, 1, 1, 1, 2, 2, 31, 9, 4, 4, 5, 4, 4, 4, 4, 4, 4, 4, 4,
    4, 4, 4, 4, 4, 4, 4, 4, 10, 2, 2, 2, 2, 2, 2, 1, 1, 1, 1, 1, 1, 1, 23,  18, 22, 1, 1, 1, 1, 1, 1, 1, 1, 1, 1, 2, 2, 2, 9, 4, 4, 4, 4, 4, 4, 4, 4, 4, 4, 4,
    4, 4, 4, 4, 5, 4, 4, 14, 13, 1, 1, 1, 1, 1, 1, 1, 1, 1, 1, 1, 1, 1, 29,  20, 30, 1, 1, 1, 1, 1, 1, 1, 1, 1, 1, 31, 2, 2, 11, 15, 4, 4, 4, 4, 4, 4, 4, 4, 4, 4,
    4, 4, 4, 4, 4, 4, 4, 10, 1, 1, 1, 1, 1, 1, 1, 1, 1, 1, 1, 2, 2, 2, 2, 2, 2, 2, 2, 1, 1, 1, 1, 1, 1, 1, 2, 2, 2, 2, 2, 11, 15, 4, 4, 4, 5, 4, 4, 4, 4, 4,
    4, 4, 4, 4, 4, 4, 5, 10, 1, 1, 1, 1, 1, 1, 1, 1, 1, 1, 2, 2, 2, 2, 2, 2, 2, 2, 2, 2, 1, 1, 2, 1, 1, 2, 2, 2, 2, 2, 2, 2, 9, 4, 4, 4, 4, 4, 4, 4, 4, 4,
    4, 4, 4, 4, 4, 4, 4, 10, 2, 1, 1, 1, 1, 1, 1, 1, 1, 1, 2, 31, 2, 2, 2, 2, 2, 31, 2, 2, 1, 1, 1, 1, 2, 2, 2, 2, 2, 31, 2, 2, 9, 4, 5, 4, 4, 4, 4, 4, 4, 4,
    4, 4, 4, 4, 4, 4, 4, 10, 2, 1, 1, 34, 1, 2, 1, 1, 1, 1, 2, 2, 31, 2, 2, 2, 2, 2, 2, 2, 2, 1, 1, 1, 2, 2, 2, 2, 2, 1, 2, 2, 9, 4, 4, 4, 4, 4, 4, 4, 4, 4,
    4, 4, 5, 4, 4, 4, 4, 10, 2, 1, 1, 1, 1, 1, 1, 1, 1, 1, 2, 2, 2, 2, 2, 2, 2, 2, 2, 2, 2, 2, 2, 2, 2, 2, 1, 2, 2, 2, 2, 2, 9, 4, 4, 4, 4, 5, 4, 4, 4, 4,
    4, 4, 4, 4, 4, 4, 4, 10, 2, 1, 1, 1, 1, 2, 1, 6, 7, 7, 8, 2, 2, 2, 2, 2, 31, 2, 2, 6, 7, 7, 8, 2, 2, 2, 2, 2, 2, 2, 31, 2, 9, 4, 4, 4, 4, 4, 4, 5, 4, 4,
    4, 4, 4, 4, 4, 4, 4, 10, 1, 1, 1, 1, 1, 1, 6,  17, 4, 4, 16, 8, 2, 2, 2, 2, 2, 2, 6,  17, 4, 4, 10, 2, 2, 1, 2, 2, 1, 2, 2, 2, 9, 4, 4, 4, 4, 4, 4, 4, 4, 4,
    4, 4, 4, 4, 5, 4, 4, 16, 7, 7, 7, 7, 7, 7,  17, 4, 4, 4, 4, 16, 7, 7, 7, 7, 7, 7,  17, 4, 5, 4, 16, 8, 2, 31, 2, 2, 2, 2, 6, 7,  17, 4, 5, 4, 4, 4, 4, 4, 4, 4,
    4, 4, 4, 4, 4, 4, 4, 4, 4, 4, 4, 4, 4, 4, 4, 4, 4, 4, 5, 4, 4, 4, 4, 4, 4, 4, 4, 4, 4, 4, 4, 16, 7, 7, 7, 7, 7, 7,  17, 4, 4, 4, 4, 4, 4, 4, 5, 4, 4, 4,
    4, 4, 4, 4, 4, 4, 4, 4, 4, 4, 4, 5, 4, 4, 4, 4, 5, 4, 4, 4, 4, 4, 4, 4, 4, 4, 4, 4, 4, 4, 4, 4, 4, 4, 4, 4, 5, 4, 4, 4, 4, 4, 4, 5, 4, 4, 4, 4, 4, 4,
    4, 4, 4, 4, 4, 4, 5, 4, 4, 4, 4, 4, 4, 4, 4, 4, 4, 4, 4, 4, 4, 4, 4, 4, 5, 4, 4, 4, 4, 5, 4, 4, 4, 4, 4, 4, 4, 4, 4, 4, 4, 4, 4, 4, 4, 4, 4, 4, 4, 4,
    4, 4, 4, 4, 4, 4, 4, 4, 4, 4, 4, 4, 4, 4, 5, 4, 4, 4, 4, 4, 5, 4, 4, 4, 4, 4, 4, 4, 4, 4, 4, 4, 5, 4, 4, 4, 4, 4, 4, 5, 4, 4, 4, 4, 4, 4, 4, 4, 4, 4,
    4, 4, 4, 4, 4, 4, 4, 4, 4, 4, 4, 4, 4, 4, 4, 4, 4, 4, 4, 4, 4, 4, 4, 4, 4, 4, 4, 5, 4, 4, 4, 4, 4, 4, 4, 4, 4, 4, 4, 4, 4, 4, 4, 4, 4, 5, 4, 4, 4, 4,
    4, 4, 4, 4, 4, 4, 4, 4, 4, 4, 4, 4, 4, 4, 4, 4, 4, 4, 4, 4, 4, 4, 4, 4, 4, 4, 4, 4, 4, 4, 4, 4, 4, 4, 4, 4, 4, 4, 4, 4, 4, 4, 4, 4, 4, 4, 4, 4, 4, 2
  ]
}